#,#,#,#,#,#,#,#,#,#,#,#,#,#,#,#,#,#,#,#,#,#,#,#,#,#,#,#,#,#,#,#,#,#,#,#,#,#,#,#,#,#,#,#,#,#,#,#,#,#,#
#,.,.,.,#,.,.,.,#,.,.,.,.,.,.,.,.,.,#,.,#,.,.,.,.,.,.,.,.,.,.,.,.,.,.,.,.,.,#,.,.,.,.,.,.,.,#,.,.,.,#
#,#,#,.,#,.,#,#,#,.,#,.,#,#,#,#,#,.,#,.,#,.,#,#,#,.,.,.,.,.,.,.,#,#,#,.,#,.,#,#,#,.,.,.,.,.,#,.,#,.,#
#,.,.,.,#,.,#,.,.,.,#,.,.,.,#,.,.,.,.,.,#,.,.,.,#,.,.,.,.,.,.,.,.,.,#,.,#,.,.,.,.,.,.,.,.,.,.,.,#,.,#
#,.,#,#,#,.,#,.,#,#,#,#,#,.,#,#,#,#,#,#,#,#,#,.,#,.,.,.,.,.,.,.,#,.,#,.,#,.,.,.,.,.,.,.,.,.,.,.,#,.,#
#,.,#,.,.,.,#,.,#,.,.,.,#,.,#,.,.,.,#,.,.,.,.,.,.,.,.,.,.,.,.,.,.,.,#,.,.,.,.,.,.,.,.,.,.,.,.,.,.,.,#
#,.,#,.,#,.,#,.,#,.,#,.,#,.,#,.,#,.,#,.,#,#,#,.,.,.,.,.,.,.,#,#,#,#,#,#,#,.,.,.,.,.,.,.,.,.,.,.,#,.,#
#,.,#,.,#,.,#,.,#,.,#,.,#,.,.,.,#,.,.,.,.,.,.,.,.,.,.,.,.,.,.,.,.,.,#,.,.,.,.,.,.,.,.,.,.,.,.,.,#,.,#
#,.,#,.,#,.,#,.,#,.,#,#,#,#,#,#,#,#,#,.,.,.,.,.,.,.,.,.,.,.,#,#,#,.,#,.,#,.,.,.,.,.,.,.,.,.,.,.,#,.,#
#,.,#,.,#,.,.,.,#,.,.,.,.,.,#,.,.,.,.,.,.,.,.,.,.,.,.,.,.,.,.,.,.,.,.,.,#,.,.,.,.,.,.,.,.,.,.,.,.,.,#
#,.,#,#,#,.,#,#,#,#,#,.,#,.,#,.,#,#,#,.,.,.,.,.,.,.,.,.,#,.,.,.,.,.,.,.,#,.,#,.,.,.,.,.,.,.,.,.,#,#,#
#,.,.,.,#,.,.,.,.,.,#,.,#,.,#,.,.,.,.,.,.,.,.,.,.,.,.,.,.,.,.,.,.,.,.,.,.,.,#,.,.,.,.,.,.,.,.,.,.,.,#
#,#,#,.,#,#,#,#,#,.,#,.,#,.,#,#,#,#,#,.,.,.,.,.,.,.,.,.,#,.,.,.,.,.,.,.,#,#,#,.,#,#,#,.,#,.,#,#,#,.,#
#,.,#,.,.,.,.,.,#,.,.,.,#,.,.,.,#,.,#,.,.,.,.,.,.,.,.,.,.,.,.,.,.,.,.,.,.,.,#,.,.,.,#,.,#,.,#,.,.,.,#
#,.,#,#,#,#,#,.,#,#,#,#,#,#,#,.,#,.,#,.,#,#,#,.,#,.,#,#,#,#,#,.,.,.,.,.,.,.,#,#,#,.,#,.,#,#,#,.,#,.,#
#,.,#,.,.,.,#,.,#,.,.,.,#,.,.,.,.,.,#,.,.,.,#,.,.,.,#,.,.,.,#,.,.,.,.,.,.,.,.,.,.,.,.,.,.,.,.,.,#,.,#
#,.,#,.,#,.,#,.,#,.,#,.,#,#,#,#,#,#,#,#,#,.,#,#,#,#,#,.,#,.,#,.,.,.,.,.,.,.,.,.,.,.,.,.,#,#,#,#,#,#,#
#,.,.,.,#,.,.,.,#,.,#,.,.,.,.,.,#,.,.,.,#,.,.,.,#,.,.,.,#,.,#,.,.,.,.,.,.,.,.,.,.,.,.,.,#,.,.,.,.,.,#
#,.,#,#,#,#,#,#,#,.,#,#,#,#,#,.,#,.,#,.,#,#,#,.,#,#,#,.,#,.,#,.,.,.,.,.,.,.,.,.,.,.,.,.,#,.,#,#,#,.,#
#,.,#,.,.,.,.,.,.,.,#,.,.,.,.,.,.,.,.,.,.,.,#,.,.,.,#,.,#,.,.,.,.,.,.,.,.,.,.,.,.,.,.,.,.,.,#,.,.,.,#
#,.,#,#,#,.,#,#,#,.,#,.,.,.,.,.,.,.,.,.,#,.,#,#,#,.,#,#,#,#,#,.,.,.,.,.,.,.,.,.,.,.,.,.,#,#,#,.,#,.,#
#,.,.,.,#,.,#,.,.,.,#,.,.,.,.,.,.,.,.,.,#,.,.,.,#,.,.,.,.,.,#,.,.,.,.,.,.,.,.,.,.,.,.,.,#,.,#,.,#,.,#
#,#,#,.,#,#,#,.,#,#,#,.,.,.,.,.,.,.,.,.,#,#,#,.,#,#,#,.,#,.,#,.,#,#,#,#,#,.,.,.,.,.,.,.,#,.,#,.,#,.,#
#,.,#,.,.,.,.,.,#,.,.,.,.,.,.,.,.,.,.,.,.,.,.,.,.,.,#,.,#,.,.,.,#,.,.,.,.,.,.,.,.,.,.,.,.,.,#,.,#,.,#
#,.,#,#,#,#,#,#,#,.,#,.,.,.,.,.,.,.,.,.,#,#,#,#,#,.,#,#,#,#,#,#,#,.,#,#,#,#,#,#,#,.,#,#,#,#,#,.,#,.,#
#,.,.,.,.,.,.,.,#,.,#,.,.,.,.,.,.,.,.,.,#,.,.,.,#,.,.,.,.,.,#,.,.,.,#,.,.,.,.,.,#,.,.,.,.,.,.,.,#,.,#
#,.,#,#,#,.,#,#,#,.,#,.,#,.,#,.,#,#,#,#,#,.,#,.,#,#,#,#,#,.,#,.,#,#,#,.,#,#,#,.,#,#,#,#,#,#,#,#,#,#,#
#,.,.,.,#,.,.,.,.,.,#,.,.,.,#,.,.,.,.,.,#,.,#,.,#,.,#,.,.,.,.,.,.,.,#,.,.,.,#,.,.,.,.,.,.,.,.,.,.,.,#
#,#,#,.,#,#,#,#,#,#,#,#,#,#,#,#,#,#,#,.,#,.,#,.,#,.,#,.,.,.,.,.,.,.,#,#,#,.,#,#,#,#,#,#,#,#,#,#,#,.,#
#,.,#,.,.,.,.,.,.,.,.,.,.,.,.,.,.,.,#,.,#,.,#,.,#,.,#,.,.,.,.,.,.,.,.,.,#,.,.,.,.,.,.,.,.,.,.,.,#,.,#
#,.,#,#,#,#,#,#,#,#,#,#,#,#,#,#,#,.,#,.,#,.,#,.,#,.,#,.,.,.,.,.,.,.,#,#,#,#,#,#,#,.,#,#,#,#,#,#,#,.,#
#,.,.,.,.,.,#,.,.,.,.,.,.,.,#,.,.,.,#,.,.,.,#,.,#,.,.,.,.,.,.,.,.,.,.,.,.,.,.,.,#,.,#,.,.,.,.,.,#,.,#
#,.,#,#,#,#,#,.,#,#,#,#,#,.,#,.,#,#,#,#,#,#,#,.,#,.,#,.,#,.,#,#,#,.,#,#,#,#,#,.,#,.,#,.,#,#,#,.,#,.,#
#,.,.,.,.,.,#,.,.,.,.,.,#,.,.,.,#,.,.,.,#,.,.,.,#,.,#,.,.,.,.,.,.,.,.,.,.,.,.,.,.,.,.,.,#,.,.,.,.,.,#
#,#,#,#,#,.,#,#,#,#,#,.,#,#,#,#,#,.,#,.,#,.,#,#,#,.,#,.,.,.,.,.,.,.,.,.,.,.,.,.,.,.,.,.,#,#,#,#,#,#,#
#,.,.,.,.,.,#,.,#,.,.,.,#,.,.,.,.,.,.,.,.,.,#,.,.,.,.,.,.,.,.,.,.,.,.,.,.,.,.,.,.,.,.,.,.,.,.,.,.,.,#
#,.,#,#,#,.,#,.,#,.,#,#,#,.,#,#,#,.,.,.,.,.,#,.,#,#,#,.,.,.,.,.,.,.,.,.,.,.,.,.,.,.,.,.,#,#,#,#,#,.,#
#,.,.,.,#,.,.,.,#,.,.,.,#,.,#,.,.,.,.,.,.,.,#,.,#,.,.,.,.,.,.,.,.,.,.,.,.,.,.,.,.,.,.,.,.,.,#,.,.,.,#
#,.,#,.,#,.,#,#,#,#,#,.,#,.,#,#,#,.,.,.,.,.,#,.,#,.,#,.,.,.,.,.,.,.,.,.,.,.,.,.,.,.,.,.,#,.,#,.,#,#,#
#,.,#,.,#,.,#,.,.,.,.,.,#,.,.,.,#,.,.,.,.,.,#,.,.,.,#,.,.,.,.,.,.,.,.,.,.,.,.,.,.,.,.,.,#,.,#,.,.,.,#
#,#,#,.,#,#,#,.,#,#,#,#,#,#,#,.,#,.,.,.,.,.,#,#,#,.,#,.,.,.,.,.,.,.,.,.,#,.,#,#,#,.,#,#,#,.,#,#,#,.,#
#,.,.,.,#,.,.,.,#,.,.,.,.,.,.,.,#,.,.,.,.,.,.,.,#,.,#,.,.,.,.,.,.,.,.,.,.,.,#,.,.,.,#,.,#,.,#,.,.,.,#
#,.,#,#,#,.,#,#,#,.,#,#,#,#,#,#,#,.,#,#,#,.,#,.,#,#,#,.,#,.,#,.,#,.,#,#,#,.,#,.,#,#,#,.,#,.,#,.,#,#,#
#,.,#,.,.,.,#,.,#,.,.,.,#,.,.,.,#,.,.,.,#,.,#,.,.,.,.,.,#,.,.,.,#,.,.,.,#,.,.,.,#,.,.,.,#,.,#,.,.,.,#
#,.,#,.,#,#,#,.,#,.,#,.,#,.,#,.,#,#,#,.,#,#,#,#,#,.,#,#,#,#,#,#,#,#,#,.,#,#,#,#,#,#,#,.,#,.,#,.,#,.,#
#,.,#,.,#,.,.,.,.,.,#,.,#,.,#,.,.,.,#,.,.,.,.,.,#,.,.,.,.,.,.,.,.,.,#,.,.,.,#,.,.,.,.,.,#,.,#,.,#,.,#
#,.,#,.,#,.,#,#,#,#,#,.,#,#,#,#,#,.,#,#,#,#,#,.,#,#,#,.,#,#,#,#,#,.,#,#,#,.,#,.,#,.,#,.,#,.,#,#,#,.,#
#,.,#,.,#,.,.,.,.,.,#,.,.,.,.,.,#,.,#,.,.,.,.,.,#,.,.,.,#,.,.,.,#,.,.,.,#,.,#,.,#,.,#,.,#,.,#,.,.,.,#
#,.,#,.,#,#,#,#,#,#,#,#,#,#,#,.,#,.,#,.,#,#,#,#,#,#,#,#,#,.,#,.,#,#,#,#,#,.,#,.,#,.,#,#,#,.,#,.,#,.,#
#,.,.,.,.,.,.,.,.,.,.,.,.,.,.,.,#,.,.,.,.,.,.,.,.,.,.,.,.,.,#,.,.,.,.,.,.,.,#,.,#,.,.,.,.,.,.,.,#,.,#
#,#,#,#,#,#,#,#,#,#,#,#,#,#,#,#,#,#,#,#,#,#,#,#,#,#,#,#,#,#,#,#,#,#,#,#,#,#,#,#,#,#,#,#,#,#,#,#,#,#,#
