#,#,#,#,#,#,#,#,#,#,#,#,#,#,#,#,#,#,#,#,#,#,#,#,#,#,#,#,#,#,#,#
#,#,.,.,.,#,#,#,.,.,.,#,#,#,#,.,.,.,#,#,#,#,#,#,.,.,.,.,.,#,#,#
#,#,.,.,.,#,#,#,.,.,.,.,.,.,.,.,.,.,.,.,.,.,.,.,.,#,#,#,.,#,#,#
#,#,.,.,.,#,#,#,.,.,.,#,#,#,#,.,.,.,#,#,#,#,#,#,.,#,~,~,~,~,~,#
#,#,#,#,#,#,#,#,#,#,#,#,#,#,#,#,#,#,#,#,#,#,#,#,.,#,~,~,~,~,~,#
#,.,.,.,.,.,#,#,#,#,#,#,#,.,.,.,.,.,.,.,#,.,.,.,.,#,~,~,.,~,~,#
#,.,.,.,.,.,#,.,#,.,#,.,#,.,.,.,.,.,.,.,#,#,#,#,.,#,~,~,.,~,~,#
#,.,.,#,.,.,.,.,.,.,.,.,.,.,.,.,.,.,.,.,.,.,.,#,.,#,.,.,.,.,.,#
#,.,.,.,.,.,#,.,#,.,#,.,#,.,.,.,.,.,.,.,#,#,.,#,.,.,.,.,.,.,.,#
#,.,.,.,.,.,#,#,#,#,#,#,#,.,.,.,.,.,.,.,#,#,.,#,#,#,.,.,.,.,.,#
#,#,.,#,.,#,#,#,#,#,#,#,#,#,#,#,.,#,#,#,#,#,.,#,#,#,#,#,.,#,#,#
#,#,.,#,.,#,#,#,#,#,#,#,#,#,#,#,.,.,.,.,#,#,.,.,.,.,.,.,.,#,#,#
#,#,.,#,.,#,#,#,#,#,#,#,#,#,#,#,.,#,#,#,#,#,#,#,#,#,#,#,#,#,#,#
#,.,.,.,.,.,#,#,#,.,.,.,#,#,#,#,.,#,#,#,#,~,~,~,~,~,~,~,#,#,#,#
#,.,.,.,.,.,#,#,#,.,#,.,#,#,#,#,.,#,#,#,#,~,.,.,.,~,#,~,#,#,#,#
#,.,.,.,.,.,.,.,.,.,#,.,#,#,#,.,.,.,#,#,#,~,.,~,.,~,~,~,#,#,#,#
#,.,.,.,.,.,#,#,#,.,#,.,.,.,.,.,.,.,.,.,.,.,.,~,.,~,.,.,.,.,.,#
#,.,.,.,.,.,#,#,#,.,#,.,#,#,#,.,.,.,#,#,#,~,~,~,.,~,.,~,#,#,.,#
#,#,#,.,#,#,#,#,#,.,#,.,#,#,#,#,.,#,#,#,#,~,#,~,.,.,.,~,#,#,.,#
#,#,#,.,#,#,#,#,#,.,.,.,#,#,~,.,.,.,~,#,#,~,~,~,~,~,~,~,#,#,.,#
#,.,.,.,#,#,#,#,#,#,#,#,#,#,~,~,.,~,~,#,#,#,#,#,#,#,#,#,#,#,.,#
#,.,#,#,#,#,#,#,#,#,#,#,#,#,~,~,.,~,~,#,#,#,.,.,.,.,.,.,.,.,.,#
#,.,.,.,.,.,.,.,.,.,.,.,.,.,~,~,.,~,~,.,.,.,.,#,#,#,#,#,#,#,#,#
#,#,#,.,#,#,#,#,#,.,#,#,#,#,~,~,.,~,~,#,#,#,.,#,#,#,#,.,#,#,#,#
#,#,#,.,#,#,#,#,#,.,#,#,#,#,~,~,.,~,~,#,.,.,.,.,.,.,.,.,.,.,#,#
#,#,#,.,#,#,#,#,#,.,#,#,#,#,~,.,.,.,~,#,.,.,.,.,#,#,.,.,.,.,#,#
#,.,.,.,.,.,#,.,.,.,.,.,#,#,#,#,.,#,#,#,.,.,.,.,#,#,.,.,.,.,#,#
#,.,.,.,.,.,#,.,.,.,.,.,#,#,#,.,.,.,#,#,.,.,.,.,.,.,.,.,.,.,#,#
#,.,.,.,.,.,#,.,.,.,.,.,.,.,.,.,.,.,#,#,.,.,.,.,#,#,.,.,.,.,#,#
#,.,.,.,.,.,#,.,.,.,.,.,#,#,#,.,.,.,#,#,#,#,.,#,#,#,#,.,#,#,#,#
#,.,.,.,.,.,#,.,.,.,.,.,#,#,#,#,#,#,#,#,#,#,#,#,#,#,#,.,#,#,#,#
#,#,#,#,#,#,#,#,#,#,#,#,#,#,#,#,#,#,#,#,#,#,#,#,#,#,#,#,#,#,#,#
