#,#,#,#,#,#,#,#,#,#,#,#,#,#,#,#,#,#,#,#,#,#,#,#,#,#,#,#,#,#,#,#
#,#,#,#,#,#,#,#,#,#,#,#,#,#,#,#,#,#,#,#,#,#,#,#,#,#,#,#,#,#,#,#
#,#,#,#,#,#,#,#,#,#,#,#,#,#,#,#,#,#,#,#,#,#,#,#,#,#,#,#,#,#,#,#
#,#,#,#,#,#,#,#,#,#,#,#,#,#,#,#,#,#,#,#,#,#,#,#,#,#,#,#,#,#,#,#
#,#,#,#,#,#,#,#,#,#,#,#,#,#,#,#,#,#,#,#,#,#,#,#,#,#,#,#,#,#,#,#
#,#,#,#,#,#,#,#,#,#,#,#,#,#,#,#,#,#,#,#,#,#,#,#,#,#,#,#,#,#,#,#
#,#,#,#,#,#,#,#,#,#,#,#,#,#,#,#,#,#,#,#,#,#,#,#,#,#,#,#,#,#,#,#
#,#,#,#,#,#,#,#,#,#,#,#,#,#,#,#,#,#,#,#,#,#,#,#,#,#,#,#,#,#,#,#
#,#,#,#,#,#,#,#,#,#,#,#,#,#,#,#,#,#,#,#,#,#,#,#,#,#,#,#,#,#,#,#
#,#,#,#,#,#,#,#,#,#,#,#,#,#,#,#,#,#,#,#,#,#,#,#,#,#,#,#,#,#,#,#
#,#,#,#,#,#,#,#,#,#,#,#,#,#,#,#,#,#,#,#,#,#,#,#,#,#,#,#,#,#,#,#
#,#,#,.,.,.,.,#,.,.,#,.,.,.,.,#,.,.,.,.,#,#,#,#,#,#,#,#,#,#,#,#
#,#,#,.,#,#,.,#,.,#,#,#,#,#,.,#,.,#,#,.,#,#,#,#,#,#,#,#,#,#,#,#
#,#,#,.,#,#,.,#,.,#,.,.,.,.,.,#,.,#,.,.,#,#,#,#,#,#,#,#,#,#,#,#
#,#,#,.,.,#,.,#,.,#,.,#,#,#,#,#,.,#,.,#,#,#,#,#,#,#,#,#,#,#,#,#
#,#,#,#,.,#,.,#,.,.,.,#,.,.,.,.,.,#,.,.,.,.,#,#,#,#,#,#,#,#,#,#
#,#,#,#,.,#,.,#,#,#,.,#,.,#,#,#,#,#,#,#,#,.,#,#,#,#,#,#,#,#,#,#
#,#,#,.,.,#,.,.,.,.,.,.,.,#,.,.,.,.,#,.,.,.,#,#,#,#,#,#,#,#,#,#
#,#,#,#,#,#,#,#,#,#,#,#,.,#,.,#,#,.,#,.,#,#,#,#,#,#,#,#,#,#,#,#
#,#,#,.,.,.,.,.,.,.,.,.,.,#,.,#,.,.,#,.,#,.,#,#,#,#,#,#,#,#,#,#
#,#,#,.,#,#,#,.,#,#,#,#,#,#,.,#,#,#,#,.,#,.,#,#,#,#,#,#,#,#,#,#
#,#,#,.,#,.,.,.,.,.,.,.,.,.,.,#,.,.,.,.,.,.,#,#,#,#,#,#,#,#,#,#
#,#,#,.,#,#,#,#,#,.,#,#,#,#,#,#,.,#,#,#,#,.,#,#,#,#,#,#,#,#,#,#
#,#,#,.,.,.,.,.,#,.,#,.,.,.,.,.,.,#,.,.,.,.,#,#,#,#,#,#,#,#,#,#
#,#,#,#,#,.,#,.,#,.,#,.,#,.,#,#,#,#,.,#,#,#,#,#,#,#,#,#,#,#,#,#
#,#,#,.,#,.,#,.,#,.,#,.,#,.,#,.,#,.,.,#,.,.,#,#,#,#,#,#,#,#,#,#
#,#,#,.,#,.,#,.,#,#,#,.,#,.,#,.,#,.,#,#,#,.,#,#,#,#,#,#,#,#,#,#
#,#,#,.,.,.,#,.,.,.,.,.,#,.,.,.,#,.,.,.,.,.,#,#,#,#,#,#,#,#,#,#
#,#,#,#,#,#,#,#,#,#,#,#,#,#,#,#,#,#,#,#,#,#,#,#,#,#,.,.,.,#,#,#
#,#,#,#,#,#,#,#,#,#,#,#,#,#,#,#,#,#,#,#,#,#,#,#,#,#,.,.,.,#,#,#
#,#,#,#,#,#,#,#,#,#,#,#,#,#,#,#,#,#,#,#,#,#,#,#,#,#,.,.,.,#,#,#
#,#,#,#,#,#,#,#,#,#,#,#,#,#,#,#,#,#,#,#,#,#,#,#,#,#,#,#,#,#,#,#
